00000000000000000000
00000000000000000000
00000111111111111111
00001111111111111111
00011111111111111111
00111111111111111111
00111111111111111111
00111111111111111111
00011111111111111111
00001111111111111111
00000111111111111111
11100011111111111111
11110001111111111111
11111000111111111111
11110000011111111111
11100000001111111111
11000000000111111111
10000000000011111111
00000000000000000000
00000000000000000000
00000000000000000800
AAAAAAAAAAAAAAAAAAAA
AAAAAAAAAA111AAAAAAA
AA1111AAAAAAAAAAAAAA
AAAA1111111111AAAAAA
00000000000000000000
00000000000000000000
00000000000000000000
AAAAAAAAA6666666AAAA
00000000000000000000
00000000000000000000
00000000000000000000
02200220022002200220
00000000000000000000
07700770077007700770
00000000000000000000
22002200220022002200
00000000000000000000
77007700770077007700
00000000000000000000
00000000010000000000
000000001I1000000000	I=Makes you go backwards/forwards
00000001080100000000
00000010080010000000
00000100090001000000
000010000F0000100000
00010000000000010000
00100000000000001000
D100000000000000010D
00100000000000001000
00010000000000010000
00001000000000100000
00000100000001000000
00000010000010000000
00000001000100000000
00000000101000000000
00000000000000000000
00000000000000000000
000000000I0000000000
00000000000000000000
00000000000000000000
1BB10000000000000000
10801111111001111111
10800111111000111111
10800011111100111111
10080011111100111111
10080011111000111111
100E0011111000111111
10080011111000111111
10090011110001111111
11000111110011111111
11001111110011111111
11BB1111100001111111
00000000000000000000
00000000000000000000
00000000000000000000
55555555555555505555
00000000000000000000
00000000000400000000
00000000000000000000
88888888888888888888
88888888888888888888
88888888881888888888
88888888888888888888
88888888888888888888
88888888888888888888
88888888888888888888
88888888888888888888
88888888888888888888
88888888888888888888
88888888888881888888
88888888888888888888
88888888888888888888
88888888888888888888
88888888888888888888
88888888888888888888
88888888888888888888
88881888888888888888
88888888888888888888
55555551111155555555
